1111111111111
1E000001C10P1
1000000101011
1000000000001
1111111111111