1111111111111111111111111111111
10P000000100C000000000X00100001
11100000011100000C000000000E001
1000000000000111C0000C000111111
1111110001000111111100000100101
100000000100C000X00000X00111101
1001111C0000000C001110000000001
1111111111111111111111111111111