1111111111111111111111111111111111111111
1PE0000000000000000000000000000000000011
1C00000000000000000000000000000000000011
1111111111111111111111111111111111111111