1111111111
1000XCX001
1000XXX001
10000C0001
10000C0001
1P000000E1
1111111111