1111111111111111111111111111111
10P0000001000000000000X00100001
111000000100000000000000000E001
1000000000000111C00000000111111
1111110001000111111100000000001
1000000001000000X00000X00000001
1000000C0000000C001110000000001
1111111111111111111111111111111