1111111111
10001C1001
1000111001
10000C0001
10000C0001
1P000000E1
1111111111