1111111111
10000C0001
1P00E000E1
1111111111