1111111111
10000C0001
1P000Z00E1
1111111111